Atelier5
1:1
1:18
21:40
----------------------------------------
                                        
                                        
     --------------     ----------------
     |                                  
     |                                  
     |       ---------------------------
     |       |                          
     |       |                          
     |       |       |-----------       
     |       |       |                  
     |       |       |                  
     |       |       |                  
     |       |       |                  
     |       |       |------------------
     |       |                          
     |       |                          
     |       |-----------------         
     |                                  
     |                                  
----------------------------------------

